FieldName	TableName
ss:ID	Style
ss:Name	Style
ss:Name	Worksheet
Interior/ss:Color	Style
ss:Pattern	Style
ss:FontName	Style
x:Family	Style
ss:Size	Style
Font/ss:Color	Style
ss:Bold	Style
ss:Vertical	Style
%Key_Workbook_539AC23B8FB13FD7	Style
%Key_Workbook_539AC23B8FB13FD7	Worksheet
%Key_Workbook_539AC23B8FB13FD7	Workbook
ss:StyleID	Column
ss:StyleID	Cell
ss:StyleID	Row
ss:AutoFitWidth	Column
ss:Width	Column
ss:Span	Column
ss:Index	Column
ss:Index	Cell
%Key_Worksheet_5D16F62D78768350	Column
%Key_Worksheet_5D16F62D78768350	Row
%Key_Worksheet_5D16F62D78768350	Worksheet
Data	Cell
ss:Type	Cell
%Key_Row_F432AFD98B1DA64D	Cell
%Key_Row_F432AFD98B1DA64D	Row
WorksheetOptions/xmlns	Worksheet
ProtectObjects	Worksheet
ProtectScenarios	Worksheet
x:Bottom	Worksheet
x:Left	Worksheet
x:Right	Worksheet
x:Top	Worksheet
Footer/x:Margin	Worksheet
Header/x:Margin	Worksheet
Number	Worksheet
ActiveRow	Worksheet
ActiveCol	Worksheet
RangeSelection	Worksheet
HorizontalResolution	Worksheet
VerticalResolution	Worksheet
ss:ExpandedColumnCount	Worksheet
ss:ExpandedRowCount	Worksheet
x:FullColumns	Worksheet
x:FullRows	Worksheet
ss:DefaultColumnWidth	Worksheet
ss:DefaultRowHeight	Worksheet
xmlns	Workbook
xmlns:o	Workbook
xmlns:x	Workbook
xmlns:ss	Workbook
xmlns:html	Workbook
ExcelWorkbook/xmlns	Workbook
WindowHeight	Workbook
WindowWidth	Workbook
WindowTopX	Workbook
WindowTopY	Workbook
TabRatio	Workbook
ActiveSheet	Workbook
ProtectStructure	Workbook
ProtectWindows	Workbook
DisplayInkNotes	Workbook
OfficeDocumentSettings/xmlns	Workbook
DocumentProperties/xmlns	Workbook
Created	Workbook
LastSaved	Workbook
Version	Workbook
